11 10
132  132  51   132  132  132  132  132  132  132  132
132  132  67   132  132  132  132  132  25   67   86
4    132  77   132  132  132  132  132 132  132  132 
174  67   174  174  174  174  174  174  174  174  174
67   170  170  170  170  161  170  170  170  170  170
86   170  170  114  170  161  170  170  170  135  170
170  170  170  170  170  161  170  170  170  170  170
174  174  174  174  174  174  174  174  174  174  79
132  132  132  132  132  132  132  132  51   67   132
132  132  132  132  132  132  132  132  132  132  132 
