11 10
132  132  132  132  116  116  132  132  132  132  86
132  132  132  132  132  132  132  132  25   67   132
174  132  174  132  132  132  132  132  132  132  132
4    67   77   174  174  170  174  174  174  174  174
6    67   85   170  170  170  170  170  170  170  170
170  86   170  114  170  161  140  170  170  135  170
170  170  170  170  170  174  170  170  170  170  83
174  174  174  174  174  161  174  174  51   67   170
132  132  132  30   67   25   67   30   174  174  174
30   67   78   132  132  132  132  132  51   67   79
