11 11
132  132  51   132  132  132  132  132  132  67   86
132  132  67   132  132  175  132  132  25   67   89
4    67   77   132  132  132  132  132  132  132  132
174  132  174  174  174  174  174  174  174  174  174
67   170  170  170  170  161  170  170  170  170  170
86   170  170  114  170  161  170  170  170  135  170
170  170  170  25   170  161  170  170  170  170  170
4    65   67   132  88   174  174  174  51   67   79
132  67   87   132  132  132  132  132  67   132  132
67   132  132  132  132  132  132  87   90   132  132
86   132  132  132  132  51   67   132  132  132  132
