11 9
132  132  132  132  132  132  132  132  25   67   86
4    67   77   132  132  132  51   67   132  132  132 
174  174  174  174  174  174  174  174  174  174  174
67   170  170  170  170  161  170  170  170  170  170
86   114  170  170  170  161  170  170  170  135  170
170  170  170  170  170  161  170  170  170  170  170
174  174  174  174  174  174  174  174  174  174  174
132  132  132  132  132  132  132  132  132  132  132 
132  132  132  132  132  132  132  132  51   67   79
