11 10
132  132  132  132  132  132  132  132  132  132  86
132  132  132  132  132  132  132  132  25   67   132
4    67   77   132  132  132  132  132  132  132  132
174  132  174  174  174  161  174  174  174  174  174
170  170  170  170  170  174  170  170  170  170  170
170  86   170  114  140  161  140  170  170  135  170
170  170  170  170  170  174  170  170  170  170  170
174  174  174  174  174  161  174  174  174  174  79
132  132  132  30   67   25   67   30   51   67   83
30   67   78   132  132  132  132  132  51   67   79
